{
  "width": 25,
  "height": 20,
  "layout": [
    "#########################",
    "#........#.......D#.....#",
    "#...#....#........#.....#",
    "#.##...###........#.....#",
    "#.......#.#....####.....#",
    "#.....#.#.#....#........#",
    "#.....#...#.............#",
    "#.....###.#..###.#......#",
    "#.....#...#....#.#......#",
    "##.###....######........#",
    "#................#......#",
    "#......#.........#......#",
    "#......#......##..#.....#",
    "#......#...#..#...####..#",
    "#......#...###..........#",
    "#......#................#",
    "#......#................#",
    "#..S...#...#............#",
    "#......#...#............#",
    "#########################"
  ]
}
